TAG	TEXT	COMMENT
PRESENCE_ADVENTURE_MODE_BRM_CLASS_CHALLENGE	Desafio de Classe da Montanha Rocha Negra	
PRESENCE_ADVENTURE_MODE_BRM_HEROIC	Montanha Rocha Negra (Heroica)	
PRESENCE_ADVENTURE_MODE_BRM_NORMAL	Montanha Rocha Negra	
PRESENCE_ADVENTURE_MODE_NAXX_CLASS_CHALLENGE	Desafio de classe de Naxxramas	
PRESENCE_ADVENTURE_MODE_NAXX_HEROIC	Naxxramas (Heroico)	
PRESENCE_ADVENTURE_MODE_NAXX_NORMAL	Naxxramas	
PRESENCE_SCENARIO_BRM_CLASS_CHALLENGE_DRUID	Desafio do Druida da Montanha Rocha Negra	
PRESENCE_SCENARIO_BRM_CLASS_CHALLENGE_HUNTER	Desafio do Caçador da Montanha Rocha Negra	
PRESENCE_SCENARIO_BRM_CLASS_CHALLENGE_MAGE	Desafio do Mago da Montanha Rocha Negra	
PRESENCE_SCENARIO_BRM_CLASS_CHALLENGE_PALADIN	Desafio do Paladino da Montanha Rocha Negra	
PRESENCE_SCENARIO_BRM_CLASS_CHALLENGE_PRIEST	Desafio do Sacerdote da Montanha Rocha Negra	
PRESENCE_SCENARIO_BRM_CLASS_CHALLENGE_ROGUE	Desafio do Ladino da Montanha Rocha Negra	
PRESENCE_SCENARIO_BRM_CLASS_CHALLENGE_SHAMAN	Desafio do Xamã da Montanha Rocha Negra	
PRESENCE_SCENARIO_BRM_CLASS_CHALLENGE_WARLOCK	Desafio do Bruxo da Montanha Rocha Negra	
PRESENCE_SCENARIO_BRM_CLASS_CHALLENGE_WARRIOR	Desafio do Guerreiro da Montanha Rocha Negra	
PRESENCE_SCENARIO_BRM_HEROIC_SCENARIO_ATRAMEDES	Atramedes Heroico	
PRESENCE_SCENARIO_BRM_HEROIC_SCENARIO_BARON_GEDDON	Barão Geddon Heroico	
PRESENCE_SCENARIO_BRM_HEROIC_SCENARIO_CHROMAGGUS	Cromaggus Heroico	
PRESENCE_SCENARIO_BRM_HEROIC_SCENARIO_DARK_IRON_ARENA	Arena Ferro Negro Heroica	feel free to shorten long translations since the UI may squeeze text into a tiny (unreadable) font size when text is too long. this string is shown in the Friends List.
PRESENCE_SCENARIO_BRM_HEROIC_SCENARIO_DRAKKISATH	Drakkisath Heroico	
PRESENCE_SCENARIO_BRM_HEROIC_SCENARIO_GARR	Garr Heroico	
PRESENCE_SCENARIO_BRM_HEROIC_SCENARIO_GRIM_GUZZLER	Glutão Implacável Heroico	
PRESENCE_SCENARIO_BRM_HEROIC_SCENARIO_MAJORDOMO	Ragnaros, o Senhor do Fogo, Heroico	feel free to shorten long translations to 'Heroic Ragnaros' since the UI may squeeze text into a tiny (unreadable) font size when text is too long. this string is shown in the Friends List.
PRESENCE_SCENARIO_BRM_HEROIC_SCENARIO_MALORIAK	Maloriak Heroico	
PRESENCE_SCENARIO_BRM_HEROIC_SCENARIO_NEFARIAN	Lorde Victor Nefarius Heroico	feel free to shorten long translations to 'Heroic Nefarius' since the UI may squeeze text into a tiny (unreadable) font size when text is too long. this string is shown in the Friends List.
PRESENCE_SCENARIO_BRM_HEROIC_SCENARIO_OMNOTRON	Omnitron Heroico	
PRESENCE_SCENARIO_BRM_HEROIC_SCENARIO_OMOKK	Omokk Heroico	
PRESENCE_SCENARIO_BRM_HEROIC_SCENARIO_RAZORGORE	Violâminus Heroico	
PRESENCE_SCENARIO_BRM_HEROIC_SCENARIO_REND_BLACKHAND	Laceral Mão Negra Heroico	
PRESENCE_SCENARIO_BRM_HEROIC_SCENARIO_THAURISSAN	Imperador Thaurissan Heroico	feel free to shorten long translations to 'Heroic Thaurissan' since the UI may squeeze text into a tiny (unreadable) font size when text is too long. this string is shown in the Friends List.
PRESENCE_SCENARIO_BRM_HEROIC_SCENARIO_VAELASTRASZ	Vaelastrasz Heroico	
PRESENCE_SCENARIO_BRM_HEROIC_SCENARIO_ZOMBIE_NEF	Nefarian Heroico	
PRESENCE_SCENARIO_BRM_NORMAL_SCENARIO_ATRAMEDES	Enfrentando Atramedes	
PRESENCE_SCENARIO_BRM_NORMAL_SCENARIO_BARON_GEDDON	Enfrentando o Barão Geddon	
PRESENCE_SCENARIO_BRM_NORMAL_SCENARIO_CHROMAGGUS	Enfrentando Cromaggus	
PRESENCE_SCENARIO_BRM_NORMAL_SCENARIO_DARK_IRON_ARENA	Combatendo na Arena Ferro Negro	feel free to shorten long translations since the UI may squeeze text into a tiny (unreadable) font size when text is too long. this string is shown in the Friends List.
PRESENCE_SCENARIO_BRM_NORMAL_SCENARIO_DRAKKISATH	Enfrentando Drakkisath	
PRESENCE_SCENARIO_BRM_NORMAL_SCENARIO_GARR	Enfrentando Garr	
PRESENCE_SCENARIO_BRM_NORMAL_SCENARIO_GRIM_GUZZLER	Combatendo no Glutão Implacável	
PRESENCE_SCENARIO_BRM_NORMAL_SCENARIO_MAJORDOMO	Enfrentando Ragnaros, o Senhor do Fogo	feel free to shorten long translations to 'Battling Ragnaros' since the UI may squeeze text into a tiny (unreadable) font size when text is too long. this string is shown in the Friends List.
PRESENCE_SCENARIO_BRM_NORMAL_SCENARIO_MALORIAK	Enfrentando Maloriak	
PRESENCE_SCENARIO_BRM_NORMAL_SCENARIO_NEFARIAN	Enfrentando Lorde Victor Nefarius	feel free to shorten long translations to 'Battling Nefarius' since the UI may squeeze text into a tiny (unreadable) font size when text is too long. this string is shown in the Friends List.
PRESENCE_SCENARIO_BRM_NORMAL_SCENARIO_OMNOTRON	Enfrentando Omnitron	
PRESENCE_SCENARIO_BRM_NORMAL_SCENARIO_OMOKK	Enfrentando Omokk	
PRESENCE_SCENARIO_BRM_NORMAL_SCENARIO_RAZORGORE	Enfrentando Violâminus	
PRESENCE_SCENARIO_BRM_NORMAL_SCENARIO_REND_BLACKHAND	Enfrentando Laceral Mão Negra	
PRESENCE_SCENARIO_BRM_NORMAL_SCENARIO_THAURISSAN	Enfrentando o Imperador Thaurissan	feel free to shorten long translations to 'Battling Thaurissan' since the UI may squeeze text into a tiny (unreadable) font size when text is too long. this string is shown in the Friends List.
PRESENCE_SCENARIO_BRM_NORMAL_SCENARIO_VAELASTRASZ	Enfrentando Vaelastrasz	
PRESENCE_SCENARIO_BRM_NORMAL_SCENARIO_ZOMBIE_NEF	Enfrentando Nefarian	
PRESENCE_SCENARIO_NAXX_CLASS_CHALLENGE_DRUID	Desafio do Druida de Naxxramas	
PRESENCE_SCENARIO_NAXX_CLASS_CHALLENGE_HUNTER	Desafio do Caçador de Naxxramas	
PRESENCE_SCENARIO_NAXX_CLASS_CHALLENGE_MAGE	Desafio do Mago de Naxxramas	
PRESENCE_SCENARIO_NAXX_CLASS_CHALLENGE_PALADIN	Desafio do Paladino de Naxxramas	
PRESENCE_SCENARIO_NAXX_CLASS_CHALLENGE_PRIEST	Desafio do Sacerdote de Naxxramas	
PRESENCE_SCENARIO_NAXX_CLASS_CHALLENGE_ROGUE	Desafio do Ladino de Naxxramas	
PRESENCE_SCENARIO_NAXX_CLASS_CHALLENGE_SHAMAN	Desafio do Xamã de Naxxramas	
PRESENCE_SCENARIO_NAXX_CLASS_CHALLENGE_WARLOCK	Desafio do Bruxo de Naxxramas	
PRESENCE_SCENARIO_NAXX_CLASS_CHALLENGE_WARRIOR	Desafio do Guerreiro de Naxxramas	
PRESENCE_SCENARIO_NAXX_HEROIC_SCENARIO_ANUBREKHAN	Anub'Rekhan Heroico	
PRESENCE_SCENARIO_NAXX_HEROIC_SCENARIO_FAERLINA	Grã-viúva Faerlina Heroica	feel free to shorten long translations to 'Heroic Faerlina' since the UI may squeeze text into a tiny (unreadable) font size when text is too long. this string is shown in the Friends List.
PRESENCE_SCENARIO_NAXX_HEROIC_SCENARIO_GLUTH	Gluth Heroico	
PRESENCE_SCENARIO_NAXX_HEROIC_SCENARIO_GOTHIK	Gothik, o Ceifador, Heroico	feel free to shorten long translations to 'Heroic Gothik' since the UI may squeeze text into a tiny (unreadable) font size when text is too long. this string is shown in the Friends List.
PRESENCE_SCENARIO_NAXX_HEROIC_SCENARIO_GROBBULUS	Grobbulus Heroico	
PRESENCE_SCENARIO_NAXX_HEROIC_SCENARIO_HEIGAN	Heigan, o Sujo, Heroico	feel free to shorten long translations to 'Heroic Heigan' since the UI may squeeze text into a tiny (unreadable) font size when text is too long. this string is shown in the Friends List.
PRESENCE_SCENARIO_NAXX_HEROIC_SCENARIO_HORSEMEN	Os Quatro Cavaleiros Heroico	
PRESENCE_SCENARIO_NAXX_HEROIC_SCENARIO_KELTHUZAD	Kel'Thuzad Heroico	
PRESENCE_SCENARIO_NAXX_HEROIC_SCENARIO_LOATHEB	Repugnaz Heroico	
PRESENCE_SCENARIO_NAXX_HEROIC_SCENARIO_MAEXXNA	Maexxna Heroica	
PRESENCE_SCENARIO_NAXX_HEROIC_SCENARIO_NOTH	Noth, o Pestífero, Heroico	feel free to shorten long translations to 'Heroic Noth' since the UI may squeeze text into a tiny (unreadable) font size when text is too long. this string is shown in the Friends List.
PRESENCE_SCENARIO_NAXX_HEROIC_SCENARIO_PATCHWERK	Retalhoso Heroico	
PRESENCE_SCENARIO_NAXX_HEROIC_SCENARIO_RAZUVIOUS	Instrutor Razúvio Heroico	feel free to shorten long translations to 'Heroic Razuvious' since the UI may squeeze text into a tiny (unreadable) font size when text is too long. this string is shown in the Friends List.
PRESENCE_SCENARIO_NAXX_HEROIC_SCENARIO_SAPPHIRON	Sapphiron Heroico	
PRESENCE_SCENARIO_NAXX_HEROIC_SCENARIO_THADDIUS	Thaddius Heroico	
PRESENCE_SCENARIO_NAXX_NORMAL_SCENARIO_ANUBREKHAN	Enfrentando Anub'Rekhan	
PRESENCE_SCENARIO_NAXX_NORMAL_SCENARIO_FAERLINA	Enfrentando a Grã-viúva Faerlina	feel free to shorten long translations to 'Battling Faerlina' since the UI may squeeze text into a tiny (unreadable) font size when text is too long. this string is shown in the Friends List.
PRESENCE_SCENARIO_NAXX_NORMAL_SCENARIO_GLUTH	Enfrentando Gluth	
PRESENCE_SCENARIO_NAXX_NORMAL_SCENARIO_GOTHIK	Enfrentando Gothik, o Ceifador	feel free to shorten long translations to 'Battling Gothik' since the UI may squeeze text into a tiny (unreadable) font size when text is too long. this string is shown in the Friends List.
PRESENCE_SCENARIO_NAXX_NORMAL_SCENARIO_GROBBULUS	Enfrentando Grobbulus	
PRESENCE_SCENARIO_NAXX_NORMAL_SCENARIO_HEIGAN	Enfrentando Heigan, o Sujo	feel free to shorten long translations to 'Battling Heigan' since the UI may squeeze text into a tiny (unreadable) font size when text is too long. this is string shown in the Friends List.
PRESENCE_SCENARIO_NAXX_NORMAL_SCENARIO_HORSEMEN	Enfrentando os Quatro Cavaleiros	
PRESENCE_SCENARIO_NAXX_NORMAL_SCENARIO_KELTHUZAD	Enfrentando Kel'Thuzad	
PRESENCE_SCENARIO_NAXX_NORMAL_SCENARIO_LOATHEB	Enfrentando Repugnaz	
PRESENCE_SCENARIO_NAXX_NORMAL_SCENARIO_MAEXXNA	Enfrentando Maexxna	
PRESENCE_SCENARIO_NAXX_NORMAL_SCENARIO_NOTH	Enfrentando Noth, o Pestífero	feel free to shorten long translations to 'Battling Noth' since the UI may squeeze text into a tiny (unreadable) font size when text is too long. this string is shown in the Friends List.
PRESENCE_SCENARIO_NAXX_NORMAL_SCENARIO_PATCHWERK	Enfrentando Retalhoso	
PRESENCE_SCENARIO_NAXX_NORMAL_SCENARIO_RAZUVIOUS	Enfrentando o Instrutor Razúvio	feel free to shorten long translations to 'Battling Razuvious' since the UI may squeeze text into a tiny (unreadable) font size when text is too long. this string is shown in the Friends List.
PRESENCE_SCENARIO_NAXX_NORMAL_SCENARIO_SAPPHIRON	Enfrentando Sapphiron	
PRESENCE_SCENARIO_NAXX_NORMAL_SCENARIO_THADDIUS	Enfrentando Thaddius	
PRESENCE_STATUS_ADVENTURE_CHOOSING_MODE	Procurando uma aventura individual	
PRESENCE_STATUS_ADVENTURE_SCENARIO_PLAYING_GAME	{0}	{0} replaced with the specific scenario string, via PRESENCE_SCENARIO_NAXX_*
PRESENCE_STATUS_ADVENTURE_SCENARIO_SELECT	{0}	{0} replaced with the adventure mode, via PRESENCE_ADVENTURE_MODE_*, e.g. Naxxramas (Heroic) -- (originally i wanted it to say "Mission Select: Naxxramas Class Challenge" but this got too long for the UI element.)
PRESENCE_STATUS_ARENA_FORGE	Forjando um Deck da Arena	
PRESENCE_STATUS_ARENA_GAME	Batalhando na Arena	
PRESENCE_STATUS_ARENA_IDLE	Passando um tempo na Arena	
PRESENCE_STATUS_ARENA_PURCHASE	Considerando entrar na Arena	
PRESENCE_STATUS_ARENA_QUEUE	Procurando um oponente na Arena	
PRESENCE_STATUS_ARENA_REWARD	Obtendo recompensas da Arena	
PRESENCE_STATUS_COLLECTION	Dando uma olhada na coleção	
PRESENCE_STATUS_CRAFTING	Criando alguns cards	
PRESENCE_STATUS_DECKEDITOR	Criando um deck	
PRESENCE_STATUS_FRIENDLY_DECKPICKER	Preparando-se para enfrentar um amigo	
PRESENCE_STATUS_FRIENDLY_GAME	Enfrentando um amigo	
PRESENCE_STATUS_HUB	Passando um tempo no menu principal	
PRESENCE_STATUS_LOGIN	Iniciando o jogo	
PRESENCE_STATUS_PACKOPENING	Abrindo pacotes de cards!!!!	
PRESENCE_STATUS_PLAY_DECKPICKER	Entrando no Modo Jogo	
PRESENCE_STATUS_PLAY_GAME	Batalhando no Modo Jogo!	
PRESENCE_STATUS_PLAY_QUEUE	Procurando um oponente	
PRESENCE_STATUS_PRACTICE_DECKPICKER	Entrando no Modo de Treinamento	
PRESENCE_STATUS_PRACTICE_GAME	Treinando contra o Estalajadeiro	
PRESENCE_STATUS_QUESTLOG	Dando uma olhada no Registro de missões	
PRESENCE_STATUS_SPECTATING_GAME_ADVENTURE_BRM_CLASS_CHALLENGE	Assistindo a um Desafio de Classe de Rocha Negra!	
PRESENCE_STATUS_SPECTATING_GAME_ADVENTURE_BRM_HEROIC	Assistindo a uma partida Heroica de Rocha Negra!	
PRESENCE_STATUS_SPECTATING_GAME_ADVENTURE_BRM_NORMAL	Assistindo a uma batalha de Rocha Negra!	
PRESENCE_STATUS_SPECTATING_GAME_ADVENTURE_NAXX_CLASS_CHALLENGE	Assistindo a um Desafio de Classe de Naxxramas!	
PRESENCE_STATUS_SPECTATING_GAME_ADVENTURE_NAXX_HEROIC	Assistindo a uma partida de Naxxramas Heroico!	
PRESENCE_STATUS_SPECTATING_GAME_ADVENTURE_NAXX_NORMAL	Assistindo a uma batalha de Naxxramas!	
PRESENCE_STATUS_SPECTATING_GAME_ARENA	Assistindo a uma batalha de Arena	
PRESENCE_STATUS_SPECTATING_GAME_FRIENDLY	Assistindo a uma batalha amistosa	
PRESENCE_STATUS_SPECTATING_GAME_PLAY	Assistindo a uma batalha no Modo Jogo	
PRESENCE_STATUS_SPECTATING_GAME_PRACTICE	Assistindo a uma partida de treinamento	
PRESENCE_STATUS_SPECTATING_GAME_TUTORIAL	Assistindo a uma partida de tutorial	
PRESENCE_STATUS_STORE	Dando uma olhada na Loja	
PRESENCE_STATUS_TUTORIAL_GAME	Tentando derrotar {0}	0 = PRESENCE_TUTORIAL_*
PRESENCE_STATUS_TUTORIAL_PREGAME	Jogando pela primeira vez	
PRESENCE_STATUS_WELCOMEQUESTS	Considerando novas missões!	
PRESENCE_TUTORIAL_CHO	Andarilho das Lendas Cho	
PRESENCE_TUTORIAL_HEMET	Rosarães Guima	
PRESENCE_TUTORIAL_HOGGER	Hogger	
PRESENCE_TUTORIAL_ILLIDAN	Illidan Tempesfúria	
PRESENCE_TUTORIAL_MILLHOUSE	Millhouse Manavento	
PRESENCE_TUTORIAL_MUKLA	Rei Mukla	
