TAG	TEXT	COMMENT
GAMEPLAY_AI_OPPONENT_NAME	여관주인	
GAMEPLAY_BANNER_STARTING_HAND	시작 카드	
GAMEPLAY_BANNER_SUBTITLE	교환할 카드 선택	
GAMEPLAY_BANNER_WAITING	상대방이 아직 선택 중...	
GAMEPLAY_COIN_TOSS_LOST	추가 카드 획득	
GAMEPLAY_COIN_TOSS_WON	선공	
GAMEPLAY_DISCONNECT_BODY	게임이 완료되고 저장되었습니다! 하스스톤을 다시 시작해주세요.	
GAMEPLAY_DISCONNECT_BODY_RESET	게임이 완료되고 저장되었습니다! 하스스톤 서버에 다시 접속합니다.	
GAMEPLAY_DISCONNECT_HEADER	연결 끊김	
GAMEPLAY_EMOTE_LABEL_GREETINGS	인사	
GAMEPLAY_EMOTE_LABEL_OOPS	이런!	
GAMEPLAY_EMOTE_LABEL_SORRY	사과	
GAMEPLAY_EMOTE_LABEL_THANKS	감사	
GAMEPLAY_EMOTE_LABEL_THREATEN	위협	
GAMEPLAY_EMOTE_LABEL_WELL_PLAYED	칭찬	
GAMEPLAY_EMOTE_SQUELCH	차단	
GAMEPLAY_EMOTE_UNSQUELCH	차단 풀기	
GAMEPLAY_END_OF_GAME_DEFEAT	패배!	
GAMEPLAY_END_OF_GAME_VICTORY	승리!	
GAMEPLAY_END_TURN	턴 종료	
GAMEPLAY_ENEMY_TURN	상대 턴	
GAMEPLAY_ERROR_PLAY_REJECTED	제한 시간 종료!	
GAMEPLAY_FATIGUE_HISTORY_TEXT	덱에 카드가 떨어지면, 카드를 뽑아야 할 때마다 점차 큰 피해를 입습니다.	
GAMEPLAY_FATIGUE_TEXT	카드가 없습니다! {0}의 피해를 입습니다.	
GAMEPLAY_FATIGUE_TITLE	탈진	
GAMEPLAY_GOLDHERO_WINS	승!	
GAMEPLAY_HISTORY_CREATED_BY	{0} 카드로\n생성됨	0=name of a card
GAMEPLAY_MANA_COUNTER	{0}/{1}	0=unused mana 1=current total mana
GAMEPLAY_MOBILE_BATTLECRY_CANCELED	전투의 함성을 취소합니다.	
GAMEPLAY_MULLIGAN_REPLACE	교체	
GAMEPLAY_NEFARIAN_TITLE	멍청하고 무능하고 실망스러운 하수인들을 해치운 자	
GAMEPLAY_NOTIFICATION_MAX_HAND_SIZE	손에는 최대 {0}|4(장,장)의 카드를 보유할 수 있습니다.	
GAMEPLAY_NOTIFICATION_MAX_MANA	최대 {0}|4(개,개)의 마나 수정을 보유할 수 있습니다.	
GAMEPLAY_PlayErrors_REQ_ATTACK_GREATER_THAN_0	공격력이 0인 캐릭터는 공격할 수 없습니다.	
GAMEPLAY_PlayErrors_REQ_ATTACKER_CAN_ATTACK	그 캐릭터는 공격할 수 없습니다.	
GAMEPLAY_PlayErrors_REQ_ATTACKER_NOT_FROZEN	얼어붙은 캐릭터는 공격할 수 없습니다.	
GAMEPLAY_PlayErrors_REQ_CAN_BE_ATTACKED	공격할 수 있는 캐릭터가 아닙니다.	
GAMEPLAY_PlayErrors_REQ_CAN_BE_TARGETED_BY_BATTLECRIES	전투의 함성의 대상이 될 수 없습니다.	
GAMEPLAY_PlayErrors_REQ_CAN_BE_TARGETED_BY_HERO_POWERS	영웅 능력의 대상이 될 수 없습니다.	
GAMEPLAY_PlayErrors_REQ_CAN_BE_TARGETED_BY_OPPONENTS	그 캐릭터는 대상으로 삼을 수 없습니다.	
GAMEPLAY_PlayErrors_REQ_CAN_BE_TARGETED_BY_SPELLS	주문의 대상이 될 수 없습니다.	
GAMEPLAY_PlayErrors_REQ_CHARGE_TARGET	돌진 능력이 있는 캐릭터를 선택해야 합니다.	
GAMEPLAY_PlayErrors_REQ_DAMAGED_TARGET	피해를 입은 캐릭터를 선택해야 합니다.	
GAMEPLAY_PlayErrors_REQ_DRAG_TO_PLAY	끌어서 대상을 선택해야 합니다	
GAMEPLAY_PlayErrors_REQ_ENCHANTED_TARGET	강화된 캐릭터를 선택해야 합니다.	
GAMEPLAY_PlayErrors_REQ_ENEMY_TARGET	적을 선택해야 합니다.	
GAMEPLAY_PlayErrors_REQ_ENEMY_TARGET_NOT_IMMUNE	그 캐릭터는 피해 면역입니다.	
GAMEPLAY_PlayErrors_REQ_ENOUGH_MANA	마나가 부족합니다.	
GAMEPLAY_PlayErrors_REQ_ENTIRE_ENTOURAGE_NOT_IN_PLAY	이미 종류별로 토템을 사용 중입니다.	
GAMEPLAY_PlayErrors_REQ_FRIENDLY_MINION_DIED_THIS_TURN	이번 턴에는 아군 하수인이 하나도 죽지 않았습니다.	
GAMEPLAY_PlayErrors_REQ_FRIENDLY_TARGET	아군 캐릭터를 선택해야 합니다.	
GAMEPLAY_PlayErrors_REQ_FROZEN_TARGET	얼어붙은 캐릭터를 선택해야 합니다.	
GAMEPLAY_PlayErrors_REQ_HERO_OR_MINION_TARGET	캐릭터를 선택해야 합니다.	
GAMEPLAY_PlayErrors_REQ_HERO_TARGET	영웅을 선택해야 합니다.	
GAMEPLAY_PlayErrors_REQ_LEGENDARY_TARGET	전설 하수인을 선택해야 합니다.	
GAMEPLAY_PlayErrors_REQ_MINIMUM_ENEMY_MINIONS	적에게 최소한 {0}|4(명,명)의 하수인이 있어야 합니다.	
GAMEPLAY_PlayErrors_REQ_MINIMUM_TOTAL_MINIONS	전장에 최소한 {0}|4(명,명)의 하수인이 있어야 합니다.	
GAMEPLAY_PlayErrors_REQ_MINION_CAP	하수인을 더 불러낼 수 없습니다.	
GAMEPLAY_PlayErrors_REQ_MINION_CAP_IF_TARGET_AVAILABLE	하수인을 더 불러낼 수 없습니다.	
GAMEPLAY_PlayErrors_REQ_MINION_OR_ENEMY_HERO	하수인이나 적 영웅을 선택해야 합니다.	
GAMEPLAY_PlayErrors_REQ_MINION_TARGET	하수인을 선택해야 합니다.	
GAMEPLAY_PlayErrors_REQ_MUST_TARGET_TAUNTER	도발 능력이 있는 하수인이 가로막고 있습니다!	
GAMEPLAY_PlayErrors_REQ_NONSELF_TARGET	자기 자신을 선택할 수 없습니다.	
GAMEPLAY_PlayErrors_REQ_NONSTEALTH_ENEMY_TARGET	은신한 캐릭터는 대상으로 삼거나 공격할 수 없습니다.	
GAMEPLAY_PlayErrors_REQ_NOT_EXHAUSTED_ACTIVATE	그 캐릭터는 이미 공격을 마쳤습니다.	
GAMEPLAY_PlayErrors_REQ_NOT_EXHAUSTED_HERO_POWER	영웅 능력은 한 턴에 한 번 사용할 수 있습니다.	
GAMEPLAY_PlayErrors_REQ_NOT_MINION_JUST_PLAYED	이번 턴에 낸 하수인은 곧바로 공격할 수 없습니다.	
GAMEPLAY_PlayErrors_REQ_NUM_MINION_SLOTS	하수인이 너무 많아 더 불러낼 수 없습니다.	
GAMEPLAY_PlayErrors_REQ_SECRET_CAP	비밀은 오직 {0}|4(장,장)만 가질 수 있습니다.	
GAMEPLAY_PlayErrors_REQ_SUBCARD_IS_PLAYABLE	둘 다 불가능합니다.	
GAMEPLAY_PlayErrors_REQ_TARGET_ATTACKED_THIS_TURN	이미 공격한 캐릭터를 선택해야 합니다.	
GAMEPLAY_PlayErrors_REQ_TARGET_FOR_COMBO	대상이 없으면 그 카드를 낼 수 없습니다.	
GAMEPLAY_PlayErrors_REQ_TARGET_FOR_NO_COMBO	대상이 없으면 그 카드를 낼 수 없습니다.	
GAMEPLAY_PlayErrors_REQ_TARGET_IF_AVAILABLE	대상이 없으면 그 카드를 낼 수 없습니다.	
GAMEPLAY_PlayErrors_REQ_TARGET_IF_AVAILABLE_AND_DRAGON_IN_HAND	대상이 없으면 그 카드를 낼 수 없습니다.	
GAMEPLAY_PlayErrors_REQ_TARGET_MAGNET	대상으로 삼아야 하는 하수인이 존재합니다.	
GAMEPLAY_PlayErrors_REQ_TARGET_MAX_ATTACK	공격력이 {0} 이하인 캐릭터를 선택해야 합니다.	
GAMEPLAY_PlayErrors_REQ_TARGET_MIN_ATTACK	공격력이 {0} 이상인 캐릭터를 선택해야 합니다.	
GAMEPLAY_PlayErrors_REQ_TARGET_TAUNTER	도발 능력이 있는 하수인을 먼저 공격해야 합니다.	
GAMEPLAY_PlayErrors_REQ_TARGET_TO_PLAY	대상이 없으면 그 카드를 낼 수 없습니다.	
GAMEPLAY_PlayErrors_REQ_TARGET_WITH_RACE	적절한 종족이 아닙니다.	
GAMEPLAY_PlayErrors_REQ_UNDAMAGED_TARGET	피해를 입지 않은 캐릭터를 선택해야 합니다.	
GAMEPLAY_PlayErrors_REQ_UNIQUE_SECRET	이미 그 비밀을 사용했습니다.	
GAMEPLAY_PlayErrors_REQ_WEAPON_EQUIPPED	무기가 필요합니다.	
GAMEPLAY_PRE_TUTORIAL_WANTED	지명 수배	
GAMEPLAY_SECRET_BANNER_TITLE	비밀!	
GAMEPLAY_SECRET_DESC	특정 조건이 발동되면 이 비밀이 드러납니다... 조심하세요!	
GAMEPLAY_SECRET_NAME	비밀	
GAMEPLAY_SECRET_NAME_HUNTER	사냥꾼 비밀	
GAMEPLAY_SECRET_NAME_MAGE	마법사 비밀	
GAMEPLAY_SECRET_NAME_PALADIN	성기사 비밀	
GAMEPLAY_SPECTATOR_DISCONNECT_BODY	연결이 끊겼습니다. 하스스톤에 다시 접속해주세요. 관전 모드를 다시 실행해야 할 수도 있습니다.	
GAMEPLAY_SPECTATOR_DISCONNECT_BODY_RESET	연결이 끊겨 재접속 중입니다. 관전 모드를 다시 실행해야 할 수도 있습니다.	
GAMEPLAY_TOOLTIP_DECK_DESCRIPTION	나의 덱에는 {0}|4(장,장)의 카드가 있습니다.	
GAMEPLAY_TOOLTIP_DECK_HEADLINE	덱	
GAMEPLAY_TOOLTIP_ENEMYDECK_DESC	상대의 |4(덱에는 {0}장,덱에는 {0}장)의 카드가 있습니다.	
GAMEPLAY_TOOLTIP_ENEMYDECK_HEADLINE	상대방 덱	
GAMEPLAY_TOOLTIP_ENEMYHAND_DESC	상대는 {0}|4(장,장)의 카드를 손에 들고 있습니다.	0= number of cards in hand.
GAMEPLAY_TOOLTIP_ENEMYHAND_DESC_SINGLE	상대는 {0}|4(장,장)의 카드를 손에 들고 있습니다.	0= number of cards in hand.
GAMEPLAY_TOOLTIP_ENEMYHAND_DESC_TUT	상대가 낼 수 있는 카드입니다. 턴마다 한 장씩 뽑습니다.	
GAMEPLAY_TOOLTIP_ENEMYHAND_HEADLINE	상대방의 카드	
GAMEPLAY_TOOLTIP_FATIGUE_DECK_DESCRIPTION	카드가 없습니다! 카드를 뽑아야 할 때마다 피해를 입습니다.	
GAMEPLAY_TOOLTIP_FATIGUE_DECK_HEADLINE	탈진	
GAMEPLAY_TOOLTIP_FATIGUE_ENEMYDECK_DESCRIPTION	상대방이 카드가 없습니다! 상대방은 카드를 뽑아야 할 때마다 피해를 입습니다.	
GAMEPLAY_TOOLTIP_FATIGUE_ENEMYDECK_HEADLINE	탈진	
GAMEPLAY_TOOLTIP_MANA_DESCRIPTION	나의 턴이 시작되면 빈 마나 수정이 채워지고, 새 수정 한 개가 추가됩니다.	
GAMEPLAY_TOOLTIP_MANA_HEADLINE	마나 수정	
GAMEPLAY_TOOLTIP_MANA_RECALL_DESCRIPTION	과부하 능력을 가진 카드를 사용했습니다.	
GAMEPLAY_TOOLTIP_MANA_RECALL_HEADLINE	잠긴 마나 수정	
GAMEPLAY_UNKNOWN_OPPONENT_NAME	알 수 없음	
GAMEPLAY_WIN_REWARD_PROGRESS	승 {0}/{1}	
GAMEPLAY_YOUR_TURN	나의 턴	
