TAG	TEXT	COMMENT
GAMEPLAY_AI_OPPONENT_NAME	Karczmarz	
GAMEPLAY_BANNER_STARTING_HAND	Ręka startowa	
GAMEPLAY_BANNER_SUBTITLE	Zatrzymaj lub wymień	
GAMEPLAY_BANNER_WAITING	Przeciwnik wciąż wybiera...	
GAMEPLAY_COIN_TOSS_LOST	Otrzymujesz dodatkową kartę	
GAMEPLAY_COIN_TOSS_WON	Zaczynasz	
GAMEPLAY_DISCONNECT_BODY	Gra ukończona i zapisana! Uruchom ponownie Hearthstone, aby kontynuować. 	
GAMEPLAY_DISCONNECT_BODY_RESET	Gra ukończona i zapisana! Trwa ponowne łączenie z serwerami Hearthstone. 	
GAMEPLAY_DISCONNECT_HEADER	Rozłączono 	
GAMEPLAY_EMOTE_LABEL_GREETINGS	Witaj	
GAMEPLAY_EMOTE_LABEL_OOPS	Ups	
GAMEPLAY_EMOTE_LABEL_SORRY	Wybacz	
GAMEPLAY_EMOTE_LABEL_THANKS	Dzięki	
GAMEPLAY_EMOTE_LABEL_THREATEN	Groźba	
GAMEPLAY_EMOTE_LABEL_WELL_PLAYED	Nieźle	
GAMEPLAY_EMOTE_SQUELCH	Wycisz	
GAMEPLAY_EMOTE_UNSQUELCH	Anuluj wyciszenie	
GAMEPLAY_END_OF_GAME_DEFEAT	Porażka!	
GAMEPLAY_END_OF_GAME_VICTORY	Zwycięstwo!	
GAMEPLAY_END_TURN	KONIEC TURY	
GAMEPLAY_ENEMY_TURN	PRZECIWNIK	
GAMEPLAY_ERROR_PLAY_REJECTED	Za późno! Twoja tura dobiegła końca.	
GAMEPLAY_FATIGUE_HISTORY_TEXT	Próba dobrania karty z pustej talii zadaje wzrastające obrażenia twojemu bohaterowi.	
GAMEPLAY_FATIGUE_TEXT	Brak kart! Otrzymujesz {0} pkt. obrażeń.	
GAMEPLAY_FATIGUE_TITLE	Zmęczenie	
GAMEPLAY_GOLDHERO_WINS	Zwycięstwo! 	
GAMEPLAY_HISTORY_CREATED_BY	Efekt działania karty:\n{0}	0=name of a card
GAMEPLAY_MANA_COUNTER	{0}/{1}	0=unused mana 1=current total mana
GAMEPLAY_MOBILE_BATTLECRY_CANCELED	Okrzyk bojowy anulowany.	
GAMEPLAY_MULLIGAN_REPLACE	DO WYMIANY	
GAMEPLAY_NEFARIAN_TITLE	Pogromca ćwierć-inteligentnych, pół-kompetentnych i całkiem bezużytecznych stronników.	
GAMEPLAY_NOTIFICATION_MAX_HAND_SIZE	W ręce możesz mieć maksymalnie {0} |4(kartę,karty,kart)	
GAMEPLAY_NOTIFICATION_MAX_MANA	Możesz mieć maksymalnie {0} |4(kryształ many,kryształy many,kryształów many)	
GAMEPLAY_PlayErrors_REQ_ATTACK_GREATER_THAN_0	Postać bez wartości ataku nie może atakować	
GAMEPLAY_PlayErrors_REQ_ATTACKER_CAN_ATTACK	Ta postać nie może atakować	
GAMEPLAY_PlayErrors_REQ_ATTACKER_NOT_FROZEN	Zamrożona postać nie może atakować	
GAMEPLAY_PlayErrors_REQ_CAN_BE_ATTACKED	Ta postać nie może zostać zaatakowana	
GAMEPLAY_PlayErrors_REQ_CAN_BE_TARGETED_BY_BATTLECRIES	Nie można wybrać jako cel okrzyków bojowych	
GAMEPLAY_PlayErrors_REQ_CAN_BE_TARGETED_BY_HERO_POWERS	Nie można wybrać jako cel mocy specjalnych	
GAMEPLAY_PlayErrors_REQ_CAN_BE_TARGETED_BY_OPPONENTS	Ta postać nie może zostać namierzona	
GAMEPLAY_PlayErrors_REQ_CAN_BE_TARGETED_BY_SPELLS	Nie można wybrać jako cel zaklęć	
GAMEPLAY_PlayErrors_REQ_CHARGE_TARGET	Wybierz postać z Szarżą	
GAMEPLAY_PlayErrors_REQ_DAMAGED_TARGET	Wybierz ranną postać	
GAMEPLAY_PlayErrors_REQ_DRAG_TO_PLAY	Musisz przeciągnąć to na cel	
GAMEPLAY_PlayErrors_REQ_ENCHANTED_TARGET	Wybierz zauroczoną postać	
GAMEPLAY_PlayErrors_REQ_ENEMY_TARGET	Wybierz wroga	
GAMEPLAY_PlayErrors_REQ_ENEMY_TARGET_NOT_IMMUNE	Ta postać jest niewrażliwa	
GAMEPLAY_PlayErrors_REQ_ENOUGH_MANA	Za mało many	
GAMEPLAY_PlayErrors_REQ_ENTIRE_ENTOURAGE_NOT_IN_PLAY	Masz już każdy rodzaj totemu	
GAMEPLAY_PlayErrors_REQ_FRIENDLY_MINION_DIED_THIS_TURN	W tej turze nie zginęli żadni przyjaźni stronnicy	
GAMEPLAY_PlayErrors_REQ_FRIENDLY_TARGET	Wybierz przyjazną postać	
GAMEPLAY_PlayErrors_REQ_FROZEN_TARGET	Wybierz zamrożoną postać	
GAMEPLAY_PlayErrors_REQ_HERO_OR_MINION_TARGET	Musisz wskazać postać	
GAMEPLAY_PlayErrors_REQ_HERO_TARGET	Musisz wskazać bohatera	
GAMEPLAY_PlayErrors_REQ_LEGENDARY_TARGET	Musisz wskazać legendarnego stronnika	
GAMEPLAY_PlayErrors_REQ_MINIMUM_ENEMY_MINIONS	Wróg musi mieć co najmniej {0} |4(stronnika,stronników,stronników)	
GAMEPLAY_PlayErrors_REQ_MINIMUM_TOTAL_MINIONS	Na polu bitwy musi być co najmniej {0} |4(stronnik,stronników,stronników)	
GAMEPLAY_PlayErrors_REQ_MINION_CAP	Nie możesz mieć więcej stronników	
GAMEPLAY_PlayErrors_REQ_MINION_CAP_IF_TARGET_AVAILABLE	Nie możesz mieć więcej stronników	
GAMEPLAY_PlayErrors_REQ_MINION_OR_ENEMY_HERO	Wybierz stronnika lub wrogiego bohatera	
GAMEPLAY_PlayErrors_REQ_MINION_TARGET	Wybierz stronnika	
GAMEPLAY_PlayErrors_REQ_MUST_TARGET_TAUNTER	Na drodze stoi stronnik z prowokacją!	
GAMEPLAY_PlayErrors_REQ_NONSELF_TARGET	Stronnik nie może sam się wskazać	
GAMEPLAY_PlayErrors_REQ_NONSTEALTH_ENEMY_TARGET	Ukryte postaci nie mogą być atakowane lub wskazywane	
GAMEPLAY_PlayErrors_REQ_NOT_EXHAUSTED_ACTIVATE	Ta postać już atakowała	
GAMEPLAY_PlayErrors_REQ_NOT_EXHAUSTED_HERO_POWER	Moce specjalne można wykorzystać tylko raz na turę	
GAMEPLAY_PlayErrors_REQ_NOT_MINION_JUST_PLAYED	Stronnicy nie mogą atakować w turze,\nw której zostali zagrani	
GAMEPLAY_PlayErrors_REQ_NUM_MINION_SLOTS	Nie możesz zagrać tej karty, gdyż masz za dużo stronników	
GAMEPLAY_PlayErrors_REQ_SECRET_CAP	Możesz mieć maksymalnie {0} |4(sekret,sekrety,sekretów)	
GAMEPLAY_PlayErrors_REQ_SUBCARD_IS_PLAYABLE	Żadna z tych opcji nie jest dostępna	
GAMEPLAY_PlayErrors_REQ_TARGET_ATTACKED_THIS_TURN	Musisz wskazać postać, która już atakowała	
GAMEPLAY_PlayErrors_REQ_TARGET_FOR_COMBO	Nie możesz zagrać tej karty nie mając celu	
GAMEPLAY_PlayErrors_REQ_TARGET_FOR_NO_COMBO	Nie możesz zagrać tej karty nie mając celu	
GAMEPLAY_PlayErrors_REQ_TARGET_IF_AVAILABLE	Nie możesz zagrać tej karty nie mając celu	
GAMEPLAY_PlayErrors_REQ_TARGET_IF_AVAILABLE_AND_DRAGON_IN_HAND	Nie możesz zagrać tej karty nie mając celu	
GAMEPLAY_PlayErrors_REQ_TARGET_MAGNET	Jest już stronnik, który musi zostać wskazany	
GAMEPLAY_PlayErrors_REQ_TARGET_MAX_ATTACK	Wybierz postać z atakiem {0} lub mniejszym	
GAMEPLAY_PlayErrors_REQ_TARGET_MIN_ATTACK	Wybierz postać z atakiem równym {0} lub większym	
GAMEPLAY_PlayErrors_REQ_TARGET_TAUNTER	Musisz zaatakować stronnika z Prowokacją	
GAMEPLAY_PlayErrors_REQ_TARGET_TO_PLAY	Nie możesz zagrać tej karty nie mając celu	
GAMEPLAY_PlayErrors_REQ_TARGET_WITH_RACE	To nie jest odpowiednia rasa	
GAMEPLAY_PlayErrors_REQ_UNDAMAGED_TARGET	Musisz wskazać niezranionego stronnika.	
GAMEPLAY_PlayErrors_REQ_UNIQUE_SECRET	Posiadasz już ten Sekret	
GAMEPLAY_PlayErrors_REQ_WEAPON_EQUIPPED	Nie masz broni	
GAMEPLAY_PRE_TUTORIAL_WANTED	Poszukiwany	
GAMEPLAY_SECRET_BANNER_TITLE	Sekret!	
GAMEPLAY_SECRET_DESC	Karta pozostaje ukryta do spełnienia sekretnego warunku... Uważaj!	
GAMEPLAY_SECRET_NAME	Sekret	
GAMEPLAY_SECRET_NAME_HUNTER	Sekret łowcy	
GAMEPLAY_SECRET_NAME_MAGE	Sekret maga	
GAMEPLAY_SECRET_NAME_PALADIN	Sekret paladyna	
GAMEPLAY_SPECTATOR_DISCONNECT_BODY	Nastąpiło rozłączenie. Aby kontynuować, ponownie uruchom Hearthstone. Może być konieczne ponowne uruchomienie trybu widza.	
GAMEPLAY_SPECTATOR_DISCONNECT_BODY_RESET	Nastąpiło rozłączenie. Trwa ponowne dołączanie. Może być konieczne ponowne uruchomienie trybu widza.	
GAMEPLAY_TOOLTIP_DECK_DESCRIPTION	Masz {0} |4(kartę,karty,kart) w talii.	
GAMEPLAY_TOOLTIP_DECK_HEADLINE	Talia	
GAMEPLAY_TOOLTIP_ENEMYDECK_DESC	Przeciwnik ma {0} |4(kartę,karty,kart) w talii.	
GAMEPLAY_TOOLTIP_ENEMYDECK_HEADLINE	Talia przeciwnika	
GAMEPLAY_TOOLTIP_ENEMYHAND_DESC	Przeciwnik ma {0} |4(kartę,karty,kart) w ręce.	0= number of cards in hand.
GAMEPLAY_TOOLTIP_ENEMYHAND_DESC_SINGLE	Przeciwnik ma {0} |4(kartę,karty,kart) w ręce.	0= number of cards in hand.
GAMEPLAY_TOOLTIP_ENEMYHAND_DESC_TUT	Karty przeciwnika. Gracze co turę dobierają jedną kartę.	
GAMEPLAY_TOOLTIP_ENEMYHAND_HEADLINE	Ręka przeciwnika	
GAMEPLAY_TOOLTIP_FATIGUE_DECK_DESCRIPTION	Nie masz już kart! Od tej pory będziesz otrzymywać obrażenia za każdym razem, gdy spróbujesz dobrać kartę.	
GAMEPLAY_TOOLTIP_FATIGUE_DECK_HEADLINE	Zmęczenie	
GAMEPLAY_TOOLTIP_FATIGUE_ENEMYDECK_DESCRIPTION	Twój przeciwnik nie ma już kart! Od tej pory będzie otrzymywać obrażenia za każdym razem, gdy spróbuje dobrać kartę.	
GAMEPLAY_TOOLTIP_FATIGUE_ENEMYDECK_HEADLINE	Zmęczenie	
GAMEPLAY_TOOLTIP_MANA_DESCRIPTION	Kiedy zaczyna się twoja tura, otrzymujesz nowy kryształ i wypełniasz puste.	
GAMEPLAY_TOOLTIP_MANA_HEADLINE	Kryształy many	
GAMEPLAY_TOOLTIP_MANA_RECALL_DESCRIPTION	W poprzedniej turze zagrano kartę z Przeciążeniem.	
GAMEPLAY_TOOLTIP_MANA_RECALL_HEADLINE	Zablokowane kryształy many	
GAMEPLAY_UNKNOWN_OPPONENT_NAME	NIEZNANE	
GAMEPLAY_WIN_REWARD_PROGRESS	Wygrane: {0}/{1}	
GAMEPLAY_YOUR_TURN	Twoja tura	
